

C 220,0    ,     34
NO ./path_to_the_north_texture


F 220    ,0,100
SO ./path_to_the_south_texture
WE ./path_to_the_west_texture
EA ./path_to_the_east_texture

1111111111111
1001100N00001
1001100000001
1111111111111