1111111111111
1111111111111
1111111111111
1  11000001
1  11000001
1111111111111
1111111111111
1  110W0001
1  1000001111
1   11000001
1111111111111




