1111111111111
1111111111111
1111111111111
1001100N00001
1001100000001
1111111111111