

C                 254  ,   100 ,    0
NO texture/wood.xpm

SO texture/purplestone.xpm
WE texture/RED-BRICK.xpm
EA texture/winter.xpm

F 0    100    ,  100

        1 1111111111111111111111111111111
        111111111111111111111111111111111
        100000000011101E1000000011111111
        101100000101000000000001
        1001000000000000000000001
11111111101100000111000000000001
100000000011000001110111111111111
11110111111111011100000010001
11110111111111011101010010001
11000000110101011100000010001
10000000000000001100000010001
10000000000000001101010000001
1100000111010101111101111000111
11110111 1110101 101111010001
11111111 1111111 111111111111
