

C 220,0    ,     34
NO  RED-BRICK.xpm


F 220    ,0,100
SO  RED-BRICK.xpm
WE RED-BRICK.xpm
EA RED-BRICK.xpm

1111111111111
1111111111111
1001101100011
1001101N10001
1111111111111