

C 220,0    ,     34
NO ./path_to_the_north_texture


F 220    ,0,100
SO ./path_to_the_south_texture
WE ./path_to_the_west_texture
EA ./path_to_the_east_texture

1111111111111111111111111
1000000000110000000000001
1011000001110000000000001
1001000000000000000000001
1001000000000000000000001
101000000111000000N000001
1000000000000000000000001
1000000000000000000000001
1000000000000000000000001
1111111111111111111111111