

C                 254  ,   100 ,    0
NO wood.xpm

SO purplestone.xpm
WE RED-BRICK.xpm
EA winter.xpm

F 0   , 100    ,  100

        1 1111111111111111111111111111111
        111111111111111111111111111111000
        100000000011100000000000011111111
        1011000001010000000000001
        1001000000000000000000001
111111111011000001110000S0000001
100000000011000001110111111111111
11110111111111011100000010001
11110111111111011101010010001
11000000110101011100000010001
10000000000000001100000010001
10000000000000001101010000001
1100000111010101111101111000111
11110111 1110101 101111010001
11111111 1111111 111111111111
